Justice.ArrestJail	Justice.ArrestJailDetain.ArrestJailDetain
Justice.ChargeIndict	Justice.InitiateJudicialProcess.ChargeIndict
Justice.TrialHearing	Justice.InitiateJudicialProcess.TrialHearing
Justice.Investigate	Justice.Investigate.InvestigateCrime
Justice.Convict	Justice.JudicialConsequences.Convict
Justice.Execute	Justice.JudicialConsequences.Execute
Justice.Extradite	Justice.JudicialConsequences.Extradite
Transaction.TransferControl	Transaction.Transaction.TransferControl
Government.Legislate	Government.Legislate.Legislate
Government.Spy	Government.Spy.Spy
Inspection.People	Inspection.SensoryObserve.InspectPeopleOrganization
Inspection.Artifact	Inspection.SensoryObserve.PhysicalInvestigateInspect
Personnel.Nominate	Personnel.Elect
Justice.ReleaseParole	Justice.JudicialConsequences
Justice.Sue	Justice.InitiateJudicialProcess
Justice.Sentence	Justice.JudicialConsequences
Justice.Fine	Justice.JudicialConsequences
Justice.Acquit	Justice.JudicialConsequences
Justice.Appeal	Justice.InitiateJudicialProcess
Justice.Pardon	Justice.JudicialConsequences